1111111111111111111
1P00000000000000101
1000000000000000011
1000000000000000001
1CCCCCCCCCCCCCCCCC1
1000000000010000001
1000000000101000001
1100000000010000001
10100000000000000E1
1111111111111111111