111111111111
1P0001011001
1000011110C1
1C0001111001
1000000000E1
111111111111