1111111111
1P00010001
10000100C1
1C00010001
10000000E1
1111111111