1111111111
1P000C0001
1011110111
1010111C01
1010101011
10000C00E1
1111111111