111111111111
1P0001000001
1000010000C1
1C0001000001
1000000000E1
111111111111