1111111111111111001
1P0010101010101E001
1110100010001010001
1000001010100010001
1111101010111010001
1000001010100010001
1111111010101110001
1000000000000010001
111111111C101000001
1000000000000000001
1000000000000000001
1000000000000000001
1000000000000000001
1000000000000000001
1000000000000000001
1111111111111111111