111111111111
1P000100C001
100001000001
100001111E11
1000000000C1
111111111111