11111111111
1P000000101
11000000011
10100000101
11000000011
10000101001
10000100111
100010100C1
10000111111
100000000E1
11111111111